%%%%%%%%%%%%%%%%%%%%%%%%%%%%%%%%%%%%%%%%%%%%%%%%%%%%%%%%%%%%%%%%%%%%%%%%%%%%%%%%%
%.%           %               ...     %   %     %       %   %               %  .%
% % %%% %%% %%% %% %%%%%%%%%% %%%%%%% %%% % %%% % % %%% % % % %%%%% %%% %%%%% % %
%   %     %   % %   %       %   %   %   % % %   % % %     % %     % % % %     % %
% %%%%    %%% % %%% % % %%% %%% % % %%% % % % %%% % %%%%% % %     % % % % %%% % %
%         %   %   %   % % % %   % %       %     %       % % % %   % %   % %   % %
%%% %% %% % %%%%% % %%% % % %  %% % %%%% %% %%% % %%%%% % % % % %%% % %%% % %%% %
%       % % %   % % % % %   %     % %       % %   %   %   %     %   % %   % % % %
% %%%%%%% % % % % % % % %%% % %%%%% % %%%%%%% %%%%%%% %%%%%%% %%% %%% %%%%% % % %
%     %   %   %   % % %   %   %    .      %     %   %   %         %   %   % % % %
%%%%% % %%%%%   %%% % %%% % %%% %%%     % % %%% % % %%% % %%%%%%% %%% %%% % % % %
%      .  %     %   % %   % %   %   %   %   %     %   . %   %   % %     % % %   %
% %%%%%%% % %%%%% %%% % %%% % %%%%%%% %%%%%%%%%%% %%% %%% % % % %%% % %%% % % %%%
%       % %           % %   %         %         % %   %   % % % %   %     % %   %
%%% % %%% %%%%% %%%%%%% %%% %    %% %%% %%%%% % %%% % %       % % %%%% %%%% %%% %
%   %   %     %   %   %       %  .      %       %   %   % %   %           % %   %
% % %%% %%%%% % %%% % %%%%% % % %%%%%%%%% %% %%%% % %%%%% %% %%%%%%%%%% %%% % %%%
% %    .    % % %   % %   % % % ...   %   %       . %   %         %     %   % % %
% % %%% %%%%% % % %%% % % %%% %%%%%%% %%% % %%% % %%% % %% %%%%   .    %% %%% % %
%   %   %   % %     % %     %    .      % %   % % %   %     %     %     %   % % %
% % %%%%% % % % %%% % % %%% %%% % %%    % %%%%% %%% %%% %%% % %%%%% %%% %%% % % %
% %       % % %   % %   % %  .  % %     %     %           % %       % %   % %   %
% %%% % %%% % %%% % %  %% %%% %%% % %% %%%% % %%%%% %     % %   %% %% %%% % %%% %
% %   % % %   % % %  .  %   % %   % %       %     % %     %   % %     %   %     %
%   % % % %   % % %     % % % %%% % % %%%%% %%%%% % % %%%%% % % % %%% % %%% % %%%
%   % %     %     %...  % %   %   % % %     %     % % %     %   %       %   % % %
%%% %%%% %% % %  %% %% %% % %%% % % % % %%% % %%%%% % % %%%%% %   % % %%% % % % %
%   %     % % %   % %   %   % % % % % %   % % %     % %   %   %     %   % %  .  %
%   % %%% % %%% % % % % % %%% % % % % %%% %%% %% %%%% % % % % % %%%%% % %%% %%% %
%P  %   %    .  % % % % .   %   %   %   %     .       % %   %         %     %   %
%%%%%%%%%%%%%%%%%%%%%%%%%%%%%%%%%%%%%%%%%%%%%%%%%%%%%%%%%%%%%%%%%%%%%%%%%%%%%%%%%
