%%%%%%%%%%%
%P .%%%%%%%
%   %%%%%%%
%.%.     .%
%%%%%%%%%%%