%%%%%%%%%%%%%%%%%%%%%%%%%%%%%%%%%%%%%%%%%%%%%%%%%
% .  %        .%    % %      %  .%     % %   % .%
%    %%%% %%%%%% %  % % %%   %     %%%%% %. %%% %
%    %.%    % .% %  % %  %   %   %          %   %
%   .            %.     %%%% %   %% .%%% %      %
% %%%%%         %%%% %%          .%    %. %%%%%%%
%.      %   .%       .% %%%  % %%%%  % %  %   % %
%%% %%  %               %    % %. %% % %    %.% %
%    %  %      %  %      P%%%% %     % % %%%% % %
%       %   %  %  %     %      %  %% %     .%   %
%%% %%%   .%%%          %%% %% %  %.            %
%.  %    %    %              %    %       .     %
%%%%%%%%%%%%%%%%%%%%%%%%%%%%%%%%%%%%%%%%%%%%%%%%%